regulation: quy định
regulate: điều khiển (control)
attire: quần áo, cách ăn mặc
concern: lo lắng, mối quan ngại, dính líu đến
involve: ảnh hưởng, liên quan đến
affect: ảnh hưởng
exception: ngoại lệ (thường đi với with)
comply: tuần thủ (thường đi với with)
observe: tuân thủ
obey: làm theo chỉ thị
policy: chính sách, quy chế
severly: nghiêm khắc
refrain: kiềm chế, hạn chế (thường đi với from)
restrict: giới hạn, hạn chế
access: truy cập, đường vào, sự lui tới
accessiblity: khả năng tiếp cận
approach: tiếp cận
approval: sự phê duyệt
thoroughly: một cách kỹ lưỡng
revise: sửa đổi, thay đổi
immediately: ngay lập tức
procedure: thủ tục
proceed: tiến hành, tiếp diễn
negative: tiêu cực
possitive: tích cực
mandate: ra lệnh, ủy quyền, ủy thác, lệnh
authorize: ủy quyền, cho phép
effect: hiệu quả, hiệu lực, đem lại
drastically: một cách mạnh mẽ
drastic: mạnh mẽ, quyết liệt
according to: theo như
standard: tiêu chuẩn, trình độ
constant: liên tục
constantly: một cách liên tục
obligation: nghĩa vụ, trách nghiệm
effort: nổ lực, cố gắng
prohibit: ngăn cấm, không cho phép
forbid: ngăn cấm
ban: lệnh cấm
connvention: tập quán của cộng đồng, xã hội