special: đặc biệt
specialist: chuyên gia
regarding: liên quan
enthusiast: người say mê
complimantary: miễn phí
evaluation: đánh giá
catering: dịch vụ ăn uống
measures: kế hoạch, giải pháp
stratgy: kế hoạch
campaign: kế hoạch
sesitive: nhạy cảm
essential: thiết yếuyếu
potential: tiềm năng
effectiveness: sự hiệu quả
conduct: tiến hành
implement: thực hiện, triển khai
invest: đầu tư
present: món quà, hiện tại, có mặt, trình bày
representative: người đại diện
testament ~ proof: bằng chứng
formula: công thức
surrouding: giữ gìn
spotless: không dơ bẩn
scent: mùi hương
brochure: quảng cáo
guarantee: bảo đảm, bảo hành
insurance: bảo hiểm
promptly: nhanh chóng
substitude ~ replacement: vật thay thế
track: giám sát
detect: phát hiện
appetizer: khai vị
main courses: món chính
dessert: tráng miệng
stuff: nhồi nhết
mushrooms: nấm
profits: lợi nhuận
revenue: doanh thu
conference: hội thảo
interprete: thông dịch, diễn giải
intense: căng thẳng
guide: hướng dẫn, người hướng dẫn
guideline: chuỗi bài hướng dẫn
